CATCC	Zea_perennis
TTCCC	Tripsacum_dactyloides
GGGGT	Tripsacum_laxum
AGTGT	Tripsacum_floridanum
CCGGT	Tripsacum_australe_v._hirsutum
ACAGT	Urelytrum_digitatum
TGCGT	Ischaenum_rugosum
TCGCT	Arundinella_nepalensis
AAGCT	Hemarthria_altissima
CACGT	Hyparrhenia_hirta
CGAGT	Chionachne_koenigii
TTAGT	Chysopogon_serrulatus
AATGA	Chamopodium_caudatum
AGGAC	Triticum_urartu
TATCA	Panicum_capillare
AACTT	Sorghum_bicolor_sp_bicolor
CGCGA	Brachypodium_distachyon
CGTAT	Apluda_mutica
CGACA	Tripsacum_andersonii
TTTGC	Phyllostachys_edulis
CCACT	RIMMA0019.J
GATTT	Tripsacum_peruvianus